XXXXXXXXXXXXXXOXXXXXXXXXXXXXXX
XOOOOOOOOOXXOOOXOOOOXXXXXXOOOX
XOXXXXXXXOXOOXOOOXXOOOOOOOOXOX
XOXOXOOOOOXOXXXXXOOOXXXXXXXXOX
XOXOXOXXXOXOOOOXXOXXOOOXOOOXOX
XOXOOOXOOOXOXXOOOOXOOXOXXXOXOX
XOXXXOOOXOXOOXOXOXOOXXOOOOOXOX
XOXOOOXXXOXXOXXXXXOXOXOXOXXXOX
XOXOXOOOOOOXOXOOOXOXOOOXOOOXOX
XOXOOOXOXXOOOOXXOOOXXOXXOXOXOX
XOXOXOXOXXXXOXXXOXOOOOOOOXOXOX
XOXOXOXOOOOXOXOXXXXXOXXXXOOXOX
XOXOXOOXXXOX00000OOXOOOOOOXXOX
XOXOXXOOOXOO00000XOOXXOXXOOXOX
XOXOOOXXOXOX00000XXOOOOOOXOXOX
XOXXXOOOOOOO00000XOOOXXXOOOXOX
XOXOOOXXXOXX00000OOXOOOXXXXXOX
XOXOXXOOOOOOOXOXXXXOOXOOOOOXOX
XOXOOOOXXOXXOXOXOOOXXXOXXXOXOX
XOXOXOXXXOXXOOOOOXOOOOOOOXOXOX
XOXOXOOOOOOXXXXXOOOXOXOXXXOXOX
XOXOXXXXXXOOOXXXXOXXOXOOOOOXOX
XOXOOOOXOOOXOOOXXOOOOXXXOXXXOX
XOXXXXOXOXOXOXOOOOXXXXXOOOOXOX
XOXOXXOOOXOOOXOXXOOOOOOOXXOXOX
XOXOOOOXOXXOXXOXXOXXXXXOOOOXOX
XOOOXXOOOXXOOOOOXOXOOOXOXXOXOX
XOXXXXXXXXXXXXXOOOXOXOOOXXXXOX
XOOOOOOOOOOOOOOXXOOOXOXOOOOOOX
XXXXXXXXXXXXXXOXXXXXXXXXXXXXXX