XXXXXXXXXXXXXXOXXXXXXXXXXXXXXX
XOOOXOOOOOOOOOOOOOOOOOOOOOXXXX
XOXOXOXOXXXXOXOXOXOXOXOXXOOOOX
XOOOOOXOXOOOOXOXOXXXXXXXXXXXOX
XXXOXOXOXOXXOXOXOXXOOOOOOOXXOX
XOOOOOXOXOOXOXXXOXXOXXXXXOXXOX
XOXXXXOOXXOXXXOOOOOOXXOXXXXXOX
XOXOOOXOOOOXOXOXOXXOXXOOOOXXOX
XOXOXOOOXXXXOOOXOXXOXXOXXOXXOX
XOOOXXOXXXOOOXXOOOOOXXOXXOXXOX
XXOXXXOOOOOXXXXXXXXXXXOXXOXXOX
XOOOOOOOXXOOOXXXXOOXOOOXXOXXOX
XOXOXXXOXXOXOOOOOXOXOXXOXOOOOX
XOXOXOOOOOXXOOOOOOOOOOOOXOXXOX
XOOOXOXXXOOOOOOOOXXXOXXXXOXXOX
XOXOXOXOOOXXOOOOOOOXOOOOXOOOOX
XOXXXOXOXXOOOOOOOXOXXOXOXOXXOX
XOXOOOOOXOOXOXOXXXOOOOXOXOXXOX
XOXOXXXXXXXXOXOXXXXXXXXXXOXXOX
XOXOXOOOOOOOOOOOOOOOOOOOOOOXOX
XOXOOOXXXOXXXXOXXXXXOXXXXXXXOX
XOXOXOXXXOXOXXOOOOOOOOOOOOOOOX
XOXOXOXOOOXOOOOXXXXOXXXXXXXXXX
XOOOOOXOXOXOXXOOOOOOOOOXOOOOOX
XXXXXXXOXOXXXXXXXXXXXXOXOXOXOX
XOOOOOOOXO00000000000XOXOXXXOX
XXOXXOXOXXXXXOXXXXXXOXOOOOOXOX
XXOOOOXOXOOOOOXXXXXXOXOXXXOOOX
XOOXXXOOOXXXXXOOOOOOOXOOOOXOXX
XXXXXXXXXXXXXXOXXXXXXXXXXXXXXX