XXXXXXXXXXXXXXOXXXXXXXXXXXXXXX
XXOOOOOOOOOOOOOXXOOOOOOOOOOOOX
XOOXXXOXXOXXXXOXXOXXXXXXOXOXOX
XOXXXXOXXOOOOXOOXOXXOOOOOXOXOX
XOOXOOOXOOXXOOOXXOXXOXXXOXOOOX
XOXXXXOXXXXXXXXOXOXXOOOXOXXXXX
XOXXOXOOOOOOOOOOOOXXOXXXOXXXXX
XOXXOXXXXXXOXXXXXXOOOOOXOOOOXX
XOOOOXOXXXXOOOOOOXXXXXOOXXXOXX
XXOXXOOOOXXOXOXOXOOOOOXXXXXOXX
XXOXXOXXXXXOXOOOXOXXXOOOOOOOXX
XOOOOOXXOOOOXXXXOOXOXOXXXXXOXX
XXXXXXXXXXXXOOOOOXXOOOOOXXXOXX
XOOOOOOOOOOOOOOOOXXXOXXXOXXOXX
XXOXXXOXOXXXOOOOOXXOOOOXOOOOXX
XOOOOOOXOXXXOOOOOOOOXXXXXXXXXX
XXOXXXOXOOOOOOOOOXXOOOOOOOOOOX
XXOXOXXXXXXXXXXXXOXOXXXOXOXXOX
XOOXOXOOOOOOOOOOOOOOXXXOXOOXOX
XXOXOXXOXXXXXXXOXXXXOOOXXOXXOX
XXOXOXXOXOOOOOXOXOOOXXOXOOXXOX
XOOXOXOOXOXXXOXXXOXXXXOXXOXOOX
XXOXOXXOXOXOXOXOOOOOOOOXXOXXXX
XXOXOXXOXOXOXOXOXXOXOXXXXOOOOX
XOOOOOOOXOXOOOXOXXXXOXOOOOXXXX
XOXOXXXXXOXXXXXOXOOOOXOXXOXXXX
XOXOOOOOOOOOOOOOXOXXOOOXXOOOOX
XOXOXXXXXXXXXXXOOOOXOXXXXOXXOX
XXXOOOOOOOOOOOOXXOXXOOOOOOXXOX
XXXXXXXXXXXXXXOXXXXXXXXXXXXXXX