XXXXXXXXXXXXXXOXXXXXXXXXXXXXXX
XOOOOOXXXOOO0X0XXXOOOOOOOXXXXX
XOXXXOXXXOXXOOOOOOOXXXXXOXXXXX
XOXOXOOOOOXXXXOXXXXOOOOXOOOOXX
XOOOXXXXXOXXXXOOOOXOXXOOOXXOOX
XXXXXXOOOOOOOXXXXOXXXXOXXXXXXX
XXXXXXOXXXXXOXXXXOOOOXXXXXOOOX
XOOOOOOXXOXXOOOOXOXXOOOOOOXXOX
XOXXXXXXXOOOOXXXOOXXOXXXXOOOOX
XOXXXOOOOOXXOXXXXXOOOOOOOOXXOX
XOXXXXOXXXXXXOOOOOXXXXXXOXXXOX
XXOOOXOOOOOOOOXXXOOOOOXXOXXXOX
XXOXOXOXXXOXOOOOOXXXXOXXOXOOOX
XOOXOOOXXXOOOOOOOOOOXOXXOXOXXX
XXOXXXXXOOXXOOOOOXXOXOOOOXOOXX
XXOOOOOOOXXXOOOOOXXXXOXXXXX0XX
XXXXOXXXXOOOOOOOOOOOOOOOOOOOXX
XXXXOXXXXOXOXOOOOOXXXXXXXXXOOX
XOOOOXOOOOXOOOXOXXOOOOOOOOOXOX
XOXXXXOXXXXXXOXXOOOXXXXXXXOXOX
XOXXXXOXXXXXXXXXOXXXOXXXOXOXOX
XXOOOOOOOOOOOOOXOOOOOOOXOXOXOX
XXXXXXOXXXOXXXOXXXXXXXOXOXOXOX
XXXOOOOXOOOXOXOXXOXOOOOXOXOXOX
XOOOXOXXOXOOOXOOOOOOXXXOOXOXOX
XXXOXOXXOXXXXXXXXOXXOOOOXXOOOX
XXXXXXOOOOOOOOOXXOXXXXXXXOOXOX
XOOOOOXXXXXOXXOXXXOOOOOOOOXXOX
XOXXXOOOOOXOXXOXXXOXXXXXXXXOOX
XXXXXXXXXXXXXXOXXXXXXXXXXXXXXX
