XXXXXXXXXXXXXXOXXXXXXXXXXXXXXX
XOOOOXOOOOOOXXOXOXXXXXOOOOOXOX
XOXXOXOXXOXOXXOXOOOOOOOXXXOXOX
XOXXOXOXXOXOXXOXXXXXXXOXOXOOOX
XOXXOXOXXOXOXXOOOOOOOXOXOXOXOX
XOXXOXOXXOXOXXOXXXXXOXOXOXOXOX
XOXXOXOXXOXOOOOXOOXXOXOXOXOXOX
XOOXOOOXXOXXXXXXXOXXOXOXOXOXOX
XXOXXXXXXOOOOXOOOOXXOXOOOXOOXX
XOOOOXOOXOXXXXOXXXXXOXXXOXXOXX
XXXXOXOXXOOOOOOXOOOOOOOOOXXOXX
XOOOOOOXXOXXXXOXOXXXOXXXXXXOXX
XOXXXXXOOOXXOOOOOXOXOOOOOOOOOX
XOOOXXOOXXXXOOOOOXOXOXXXOXXOXX
XOXXOXXOOOOOOOOOOOOOOXXXOXXOXX
XOOOOXXXXXOXOOOOOXOXOXXXOXXOXX
XXXXXOOOOOOXOOOOOXOXOXOOOOXOXX
XOOOOOXXXXOXOXXXOXOXOXOXXXXOXX
XXXXXOXOXOOXOOXOOOOXOXXOOOOOXX
XOOOOOOOXOXXOXXXOXXXOXOOXXXOXX
XOXXXXXXXOXXOXOOOXOXOXXXOOOOXX
XOXOOOOOXOXXOXXXOXOXOXXOOXXOXX
XOXOXXXOXOXOOOOOOOOXOXXXXXXOXX
XOXOXOOOXOXXOXXXXXXXOXXOOOOOXX
XOXOXXXXXOXXOXXXXXXXOXXOXXXOXX
XOXOOOOOOOOOOOXXXXXXOXXXXXXOXX
XOXXOXXOXXXOXXOOOOOOOXXOOOOOXX
XOXXXXXXXXXOXXOXXOXXXXXOXOXXXX
XOOOOOOOOOOOXXOXXOOOOOOOXOOOOX
XXXXXXXXXXXXXXOXXXXXXXXXXXXXXX