XXXXXXXXXXXXXXOXXXXXXXXXXXXXXX
XXOOOOOOOOXOOOOOOOOOOOOOOOOOXX
XOOXXXOXXOXOXXOXXOXXXXXXXXOXOX
XXOXOXOXXOOOXXOXXOXOOOOOXOOOOX
XXOOOXOXXXXXOOOXXOXXXOXOXXXXOX
XOXXXOOOOOOOOXXXXOOOOOXOOOOOOX
XOOXOXOXOXXXOXXXOXXXXXXOXOXOXX
XXOXOXOXXXOOOXXXOOOOOOOOXOXOXX
XXOOOOOOOOXXXXXXOXXXXXXXXOXOXX
XXOXOXXXXOOOXXOOOOOOOOOOOOXXXX
XXOXOOXOXOXOOXOXXXOXXOXXXXOXXX
XOOXOXXOXOXXOXOXXXOOOOOOXXOOOX
XOXXOOOOOOXX0000OXXXXXXXOXXXOX
XOXOOXXOXOOOOOOOOXXOOOOOOXXOXX
XOXXXXOOOOXXOOOOOXXOXXXXXXXXXX
XOOOOOXXXOXXOOOOOOOOOOOOOOOOOX
XOXXXOOXXOXXOOOOOXXOXXXXXXXXOX
XOOOOXOXXOOOXXOXXOOOXOOOOOOXOX
XOXXOXOXXXXOXXOXOOXXXOXOXXOOOX
XOXXOXOOOOOXOOOXXXOXXOXOXXXXXX
XXOOOXOXXXXXXXOXOOOOOOXOOOOXOX
XXOXXXOOOOOOOOOXXXOXXXXXXXOXOX
XOXOOOOXXOXXOXXOOOOXOXXOOOOOOX
XXXOXOXOXOXXOOOOXXXXOOOOXXXXOX
XOXOXOOOOOOOXXXXXOOOOXXXOXOXOX
XOXXXOXXXOXOOOOXXXOXOXXXOOOOOX
XOOOOOXOXOXOXXOOOOOXOOOOOXOXXX
XOXXXOOOXOXXXXXXOXOOXXXXXOOOOX
XOOOOOXXXOOOOOOXOXXOOOOOOOXXOX
XXXXXXXXXXXXXXOXXXXXXXXXXXXXXX